############################
#@...........##............#
#.####.#####.##.#####.####.#
#.####.#####.##.#####.####.#
#.####.#####.##.#####.####.#
#..........................#
#.####.##.########.##.####.#
#.####.##.########.##.####.#
#......##....##....##......#
#.####.#####.##.#####.####.#
#.####.#####....#####.####.#
#.####.#####.##.#####.####.#
#............##...........0#
############################
