############################
#@..........####...........#
#.####.####..##..####.####.#
#.####.#####.##.#####.####.#
#.####.#####.##.#####.####.#
#..........................#
#.####.##.########.##.####.#
#.####.##.########.##.####.#
#......##....##....##......#
######.#####.##.#####.######
######.#####....#####.######
######.#####.##.#####.######
######.......##.......######
############################
