##############
#@...........#
#.####.#####.#
#.####.#####.#
#.####.#####.#
#............#
##############
