############################
#@.........................#
#..........................#
#..........................#
#..........................#
#..........................#
#..........................#
#..........................#
#..........................#
#..........................#
#..........................#
#..........................#
#.........................0#
############################
