##############
#@...........#
#.####.#####.#
#.####.#####.#
#.####.#####.#
#...........0#
##############
